11111111111111111111
10002000010000000031
14110111010111011101
10110111010111011101
10000000000000000001
10110101111110101101
10000100011000100001
11113111011011101111
11110100000000101111
10000001111110000001
11110101111110101111
11110100000000101111
10000001111110000001
10111100001000111101
10030101100000000301
10000001111110100001
11111111111111111111