11111111111111111111
10000000200000000001
10011000000000110001
10011000000000110001
10000000000000000001
10000000000000000001
10011110000000111001
10000110000000100001
10000000000000000001
11111111111111111111