11111111111111111111
10002000010000000001
14110111010111011141
10110111010111011101
10000000000000000001
10110101111110101101
10000100011000100001
11110111011011101111
11110100000000101111
10000001300010000001
11110101111110101111
11110100000000101111
10000001111110000001
10111100001000111101
10400001100000000401
10000001111110000001
11111111111111111111