11111111111111111111
10000000010000000001
14110111010111011141
10110111010111011101
10000000000000000001
10110101111110101101
10000100011000100001
11110111011011101111
11110100000000101111
00000000333300000000
11110101111110101111
11110100000000101111
10000001111110000001
10110000001000001101
14010111001011101041
11010000002000001011
10000100011000100001
10111111010011111101
10000000000000000001
11111111111111111111